MNT = "countries/Manters.txt"
SIF = "countries/Sifers.txt"
SMY = "countries/Lluvian Republic.txt"
DND = "countries/Danners.txt"
LDU = "countries/Lolduders.txt"
BES = "countries/Ninjers.txt"
PTB = "countries/Petor.txt"
SHG = "countries/Shotgunner.txt"
JON = "countries/Joaners.txt"
JSP = "countries/Jespererererers.txt"
YYJ = "countries/Yayjohners.txt"
SAN = "countries/Occidental Republic of Seantares.txt"
AMG = "countries/Mangorian Empire.txt"
DMI = "countries/Plealland.txt"
BLT = "countries/Bullet's Liberation Army.txt"
WKL = "countries/Federation of the Great Plains.txt"
EPS = "countries/Epsilon State.txt"
RNE = "countries/Rainite Republic.txt"
MQL = "countries/MasterQLFivers.txt"
KST = "countries/Kostic's Serene Republic.txt"
GOO = "countries/Ryan's Unitary Republic.txt"
GMR = "countries/Free Territories of Gamerizer.txt"
CIR = "countries/C_irci's Anointed Ecumenical Patriarchate.txt"
ZER = "countries/Zercherreich.txt"
AVI = "countries/Avienners.txt"
EDC = "countries/Ecodoc of Rising Powers.txt"
ZAQ = "countries/Kingdom of Zertania.txt"
ZEG = "countries/Governor-Generalship of Egypt.txt"
ZGR = "countries/Greek Occupational Authority.txt"
ZAT = "countries/Kingdom of Zertolia.txt"
ZIN = "countries/Dominion of Dacca.txt"
DIN = "countries/Marathi Dominion.txt"
WKH = "countries/Communes of Wackhouse.txt"
RCD = "countries/Costa Dourada Protectorate.txt"
REQ = "countries/Rainite Equatorial African Protectorate.txt"
MER = "countries/Murc.txt"
LST = "countries/Lostland.txt"
